xxxxxxxxxxxxxxxxxxxxxxxxxxxxxxxxxxxx 
x                                  x 
x                                  x 
x                                  x 
x                                  x 
x                                  x 
x                                  x 
x                                  x 
x                x                 x 
x                                  x 
x           x                      x 
x                                  x 
x                                  x 
x                                  x 
x                                  x 
x                                  x 
x                                  x 
x                                  x 
x                                  x 
x                                  x 
x                                  x 
x                                  x 
x                                  x 
xxxxxxxxxxxxxxxxxxxxxxxxxxxxxxxxxxxx 